000000000000000000000000000000000
000000000000000000000000000000000
000000000100000000000000000000000
000000001211000000000000000000000
000000017121110000000000000000000
000000121112112100000000000000000
000001112211212111000000000000000
000012111121112111110000000000000
000111211111111111222100000000000
001112211111111111112111000000000
000111111111111111112116000000000
000111111111111111111111100000000
000011111111111111111111200000000
000011111111111111111112210000000
000002221111111111111122110000000
000001112211111111111111111000000
000000511111111111111111111000000
000000111111111111111111112100000
000000022222111111111111112200000
000000011111111111111111111110000
000000001111111111111111111210000
000000001111111111111111111121000
000000000111112111111111121221000
000000000111221211111111221112100
000000000001221121211111112141000
000000000000011121211111211210000
000000000000000121121112211100000
000000000000000001312111121000000
000000000000000000012111110000000
000000000000000000000111100000000
000000000000000000000001000000000
000000000000000000000000000000000
000000000000000000000000000000000