000000000000000000000000000000000
000000000000000000000000000000000
000000000600000000000000000000000
000000001111000000000000000000000
000000011111110000000000000000000
000000111111111100000000000000000
000001111111111111000000000000000
000011111111111111110000000000000
000111111111111111111100000000000
005111111111111111111117000000000
000111111111111111111111000000000
000111111111111111111111100000000
000011111111111111111111100000000
000011111111111111111111110000000
000001111111111111111111110000000
000001111111111111111111111000000
000000111111111111111111111000000
000000111111111111111111111100000
000000011111111111111111111100000
000000011111111111111111111110000
000000001111111111111111111110000
000000001111111111111111111111000
000000000111111111111111111111000
000000000411111111111111111111800
000000000001111111111111111111000
000000000000011111111111111110000
000000000000000111111111111100000
000000000000000001111111111000000
000000000000000000011111110000000
000000000000000000000111100000000
000000000000000000000003000000000
000000000000000000000000000000000
000000000000000000000000000000000