000000000000000000000000000000000
000000000000000000000000000000000
000000000200000000000000000000000
000000002222000000000000000000000
000000022222230000000000000000000
000000222222111200000000000000000
000002222221111122000000000000000
000022222211111112220000000000000
000222222111111111222200000000000
002222221111111111122222000000000
000222211111111111112222000000000
000222111111111111111122200000000
000021111111111111111122200000000
000041111111111111111112220000000
000001111111111111111111220000000
000002111111111111111111122000000
000000211111111111111111112000000
000000221111111111111111111200000
000000022111111111111111111100000
000000022211111111111111111160000
000000002221111111111111111120000
000000002221111111111111111222000
000000000222211111111111112222000
000000000222221111111111122222200
000000000002222111111111222222000
000000000000022211111112222220000
000000000000000221111122222200000
000000000000000002111222222000000
000000000000000000052222220000000
000000000000000000000222200000000
000000000000000000000002000000000
000000000000000000000000000000000
000000000000000000000000000000000